00000000000000000000000000000000
00000000000000000000000000000000
00000000000000000000000000000000
00000000000000000000000000000000
00000000000000000000000000011000
00000000000000000000000000011000
11111111111111111111111111111111
11111111111111111111111111111111
00000001100000000000000110000000
00000001100000000000000110000000
00000001100000000000000110000000
00000001100000000000000110000000
00000001100000000000000110000000
00000001100000000000000110000000
00000001100000000000000110000000
00000001100000000000000110000000
00000001100000000000000110000000
00000001100000000000000110000000
00000001100000000000000110000000
00000001100000000000000110000000
00000001100000000000000110000000
00000001100000000000000110000000
00000001100000000000000110000000
00000001100000000000000110000000
11111111111111111111111110000000
11111111111111111111111110000000
00000000000000000000000110000000
00000000000000000000000110000000
00000000000000000000000110000000
00000000000000000000000110000000
00000000000000000000000110000000
00000000000000000000000110000000
resources/stena_3.png
resources/map_2_stena_3.png
resources/stena_3.png
resources/stena_3.png
resources/stena_3.png
resources/stena_3.png
resources/stena_3.png
resources/stena_3.png
resources/stena_3.png
resources/stena_3.png
